AXISnet|com.axis.net/com.axis.net.ui.splashLogin.SplashActivity
Acode|com.foxdebug.acodefree/com.foxdebug.acodefree.MainActivity
Action Back|io.github.u0_a316.actionback/io.github.u0_a316.actionback.MainActivity
Always On Clock|io.github.aoc_normal/com.raiden.aoc_normal.MainActivity
Amarok|deltazero.amarok.foss/deltazero.amarok.launcher.default
AndroidIDE|com.itsaky.androidide/com.itsaky.androidide.activities.SplashActivity
AniHyou|com.axiel7.anihyou/com.axiel7.anihyou.ui.screens.main.MainActivity
App Manager|io.github.muntashirakon.AppManager/io.github.muntashirakon.AppManager.main.SplashActivity
Authenticator|com.google.android.apps.authenticator2/com.google.android.apps.authenticator.AuthenticatorActivity
Average data usage widget|com.trianguloy.continuousDataUsage/com.trianguloy.continuousDataUsage.activities.Main
Binance|com.binance.dev/com.eaas.launcher.activities.main.MainActivity
Bitget Wallet|com.bitkeep.wallet/com.bitkeep.wallet.MainActivity
Bluesky|xyz.blueskyweb.app/xyz.blueskyweb.app.MainActivity
Button Mapper|flar2.homebutton/a.a
ChatGPT|com.openai.chatgpt/com.openai.chatgpt.MainActivity
Citampi Stories|com.ikanasinproduction.cintadicitampi/com.unity3d.player.UnityPlayerActivity
Crunchyroll|com.crunchyroll.crunchyroid/com.ellation.crunchyroll.presentation.startup.StartupActivity
Current Wallpaper|com.elsewhat.android.currentwallpaper/com.elsewhat.android.currentwallpaper.CurrentWallpaperActivity
Current Wallpaper|com.elsewhat.android.currentwallpaper2/com.elsewhat.android.currentwallpaper.CurrentWallpaperActivity
DANA|id.dana/id.dana.onboarding.splash.DanaSplashActivity
DeepL|com.deepl.mobiletranslator/com.deepl.mobiletranslator.MainActivity
Dialog Music Player|phone.vishnu.dialogmusicplayer/N/A
Discord|com.discord/com.discord.main.MainDefault
Drive|com.google.android.apps.docs/com.google.android.apps.docs.app.NewMainProxyActivity
Emacs|org.gnu.emacs/org.gnu.emacs.EmacsActivity
Firefox|org.mozilla.firefox/org.mozilla.firefox.App
Google Play Buku|com.google.android.apps.books/com.google.android.apps.books.app.BooksActivity
Google Play Game|com.google.android.play.games/com.google.android.gms.games.ui.destination.main.MainActivity
Google Survei Berhadiah|com.google.android.apps.paidtasks/com.google.android.apps.paidtasks.activity.LaunchActivity
Green Pass|com.michaeltroger.gruenerpass/com.michaeltroger.gruenerpass.MainActivity
HomeBot|com.abast.homebot/com.abast.homebot.MainActivity
Kalkulator|com.miui.calculator/com.miui.calculator.cal.CalculatorActivity
Kamera|com.android.MGC/com.android.camera.CameraLauncher
Keep|com.google.android.keep/com.google.android.keep.activities.BrowseActivity
Launchers Quick Tile|com.gocalsd.quicktile.launchers/N/A
Les Pas|site.leos.apps.lespas/site.leos.apps.lespas.MainActivity
LibreOffice Viewer|org.documentfoundation.libreoffice/org.libreoffice.ui.LibreOfficeUIActivity
List My Apps|io.github.luisadha.listmyapps/io.github.luisadha.listmyapps.MainActivity
MSN|com.microsoft.amp.apps.bingnews/com.microsoft.sapphire.app.main.SapphireMainActivity
Material Files|me.zhanghai.android.files/me.zhanghai.android.files.filelist.FileListActivity
Message|com.google.android.apps.messaging/com.google.android.apps.messaging.ui.ConversationListActivity
Messenger|com.facebook.orca/com.facebook.orca.auth.StartScreenActivity
Mi Doc Viewer (Didukung oleh WPS)|cn.wps.xiaomi.abroad.lite/N/A
Minecraft|com.mojang.minecraftpe/com.mojang.minecraftpe.MainActivity
Mobile Device Information Provider|com.amazon.appmanager/N/A
Mobile Legends: Bang Bang|com.mobile.legends/com.moba.unityplugin.MobaGameMainActivityWithExtractor
NMM|in.mfile/com.nmmedit.files.ui.FileManagerActivity
Nextcloud|com.nextcloud.client/com.owncloud.android.ui.activity.FileDisplayActivity
Nix|com.termux.nix/com.termux.app.TermuxActivity
OpenDocument Reader|at.tomtasche.reader/at.tomtasche.reader.ui.activity.MainActivity
OpenKeychain|org.sufficientlysecure.keychain/org.sufficientlysecure.keychain.ui.MainActivity
Paperize|com.anthonyla.paperize/com.anthonyla.paperize.feature.wallpaper.presentation.MainActivity
PayPal|com.paypal.android.p2pmobile/com.paypal.android.p2pmobile.startup.activities.StartupActivity
Pintasan HTTP|ch.rmy.android.http_shortcuts/ch.rmy.android.http_shortcuts.activities.main.MainActivity
Pintu|com.valar.pintu/com.apps.MainActivity
PlayAutoInstalls|android.autoinstalls.config.Xiaomi.qssi/N/A
QuickTiles|com.asdoi.quicktiles/com.asdoi.quicksettings.SettingsActivity
Read You|me.ash.reader/me.ash.reader.MainActivity
Rekam Layar|com.miui.screenrecorder/N/A
SaveAsTxt|io.github.saveastxt/io.github.saveastxt.MainActivity
Seal|com.junkfood.seal/com.junkfood.seal.MainActivity
Shopee|com.shopee.id/com.shopee.app.ui.home.HomeActivity_
ShopeePay|com.shopeepay.id/com.shopee.app.ui.home.HomeActivity_
Shreddit|com.palmtronix.shreddit.v1/com.palmtronix.shreddit.v1.view.AuthenticateActivity
Snapseed|com.niksoftware.snapseed/com.google.android.apps.snapseed.WelcomeScreenActivity
SoundCloud|com.soundcloud.android/com.soundcloud.android.launcher.LauncherActivity
Termux|com.termux/com.termux.app.TermuxActivity
Termux:API|com.termux.api/N/A
Termux:Boot|com.termux.boot/com.termux.boot.BootActivity
Termux:Float|com.termux.window/com.termux.window.TermuxFloatActivity
Termux:Styling|com.termux.styling/N/A
Trebuchet|com.lineageport.trebuchet/N/A
Trust Wallet|com.wallet.crypto.trustapp/com.wallet.crypto.trustapp.ui.app.AppActivity
Tux Math|org.afrikalan.tuxmath/org.afrikalan.tuxMath.game.test
Unexpected Keyboard|juloo.keyboard2/juloo.keyboard2.LauncherActivity
UnicodePad|jp.ddo.hotmist.unicodepad/jp.ddo.hotmist.unicodepad.UnicodeActivity
WhatsApp|com.whatsapp/com.whatsapp.Main
WikiTok|com.arikassia.wikitok/com.arikassia.wikitok.MainActivity
Zoom|us.zoom.videomeetings/com.zipow.videobox.LauncherActivity
bima+|com.linkit.bimatri/com.digitral.modules.splash.SplashActivity
Termux:X11|com.termux.x11/com.termux.x11.MainActivity
